11111111111
10011111111
11001111111
11101E11111
111P111C111
11100000011
11111111111