1111111111
1CX0000001
1111000P01
1EX1000C01
1111111111