111111111111111111111111111111111111111111111111111111111111
111111111111111111111111111111111111111111111111111111111111
100C000000000000000000000000000000000000000000000000000000P1
111100000001111110000000111111100000011111100000000000111111
1111000X0001111110000000111111100000000C11100000000000001111
111100000001111110000000111111100000011111100000000000111111
1E0000000000000000001100000000001100000000000C11100000101111
111100000CC111111000000011111110000001111110000000000000X111
10000000000000000000C000000000000000000C0000000000000C000XX1
100000011111CC0000011100000000000111111111000001110001001111
111100000001111110C00000111111100000011111100000000000001111
1XX0000X000000000000C000000000000000000C0000000000000C0000X1
111100000001111110000000111111100000011C11100000000000001111
1111000000C1111110000000111111100000011C11100000000000001111
1X000000000000000000C000000000000000000C0000000000000C0000X1
1111000000C1111110000000111111100000011C11100000000000001111
1111000X00C1111110000000111111100000011C111000000000000X1111
1C0000000001110000000000111X00000000001000000000001000110001
1111000000C1111110000000111111100000011C11100000000000001111
100000000000000000000000000000000000000C0000000000000C0000X1
1111000000C1111110000000111111100000011C111000000000000X1111
10X000011111C000000111X0000000000111111111000001110001XX1111
111111111111111111111111111111111111111111111111111111111111
111111111111111111111111111111111111111111111111111111111111