111111111111111111111111111111111111111111111111111111111111
111111111111111111111111111111111111111111111111111111111111
100C000000000000000000000000000000000000000000000000000000P1
111100000001111110000000111111100000011111100000000000111111
111100000001111110000000111111100000000C11100000000000001111
111100000001111110000000111111100000011111100000000000111111
1E0000000000000000001100000000001100000000000C11100000101111
111100000CC1111110000000111111100000011111100000000000001111
10000000000000000000C000000000000000000C0000000000000C000001
100000011111CC0000011100000000000111111111000001110001001111
111100000001111110C00000111111100000011111100000000000001111
10000000000000000000C000000000000000000C0000000000000C000001
111100000001111110000000111111100000011C11100000000000001111
1111000000C1111110000000111111100000011C11100000000000001111
10000000000000000000C000000000000000000C0000000000000C000001
1111000000C1111110000000111111100000011C11100000000000001111
1111000000C1111110000000111111100000011C11100000000000001111
1C0000000001110000000000111000000000001000000000001000110001
1111000000C1111110000000111111100000011C11100000000000001111
100000000000000000000000000000000000000C0000000000000C000001
1111000000C1111110000000111111100000011C11100000000000001111
100000011111C00000011100000000000111111111000001110001001111
111111111111111111111111111111111111111111111111111111111111
111111111111111111111111111111111111111111111111111111111111