111111111111
1C110000E0C1
10000P000111
101111010C01
10C0X1X1C001
111111111111