1111111111111111111111111111111111
1E0000000000000C00000C000000000001
1010010100100000101001000000010101
100001000000000C00000C000000000001
10000X000000000C00000C000000000001
100011000XX0000C0XX00C000XX0000001
100000000000000C00000C000000000001
1010010100100000101001000000010101
1010010100100000101001000XX0010101
1010010100100000101001000000010101
101001010010XX00101001000000010101
1010010100100000101001000000010101
1010010010101010001001000000010101
1010010010101010001001000000010101
1010010010101010001001000XX0010101
1010010010101010001001000000010101
1P0000000C00C0000000000011000000C1
100000100C00C000001000000000X000C1
1X0000000C00C00001100000000X0000C1
1X0011000C00C000000000000X000000C1
1X0000000C00C00000000000X1100000C1
1X0000110C00C000011000X011X00000C1
1111111111111111111111111111111111