111111111111111111111111111111111111111111111111111111111111
100C000000000000000000000000000000000000000000000000000000P1
111100000001111110000000111111100000011111100000000000111111
1E0000000000000000001100000000001100000000000C11100000101111
111100000001111110000000111111100000011111100000000000001111
100000000000000000000000000000000000000C0000000000000C000001
1C0000000001110000000000111000000000001000000000001000110001
111100000001111110000000111111100000011111100000000000001111
111111111111111111111111111111111111111111111111111111111111