1111111
100C001
10P0C01
1000E21
1111111